# Empty

mild_winter = LIST {
	4 7 27 29 35 69 71 72 82 109 136 139 142 150 176 210 211 232 236 243 249 255 264 281 299 302 307 310 315 317 324 334 343 362 371 373 375 401 403 412 435 446 448 449 456 466 469 477 478 
	517 520 522 524 527 528 532 543 580 581 585 589 604 608 609 610 614 619 628 635 636 638 639 642 648 658 664 677 687 692 717 721 729 735 739 761 764 765 766 767 771 773 783 786 793 795 797 812 836 842 
	847 856 857 858 860 869 878 890 894 896 901 909 920 930 936 940 945 960 963 975 983 992 1005 1018 1019 1020 1021 1024 1025 1043 1044 1050 1052 1057 1059 1061 1071 1081 1082 1091 1096 1104 1115 1117 1118 1124 1127 1130 1133 1136 
	1138 1139 1141 1145 1147 1148 1158 1160 1163 1164 1175 1180 1184 1186 1191 1197 1199 1201 1202 1205 1206 1208 1211 1213 1217 1226 1235 1253 1258 1259 1261 1264 1268 1274 1276 1285 1300 1301 1305 1310 1315 1319 1321 1344 1346 1347 1362 1369 1376 1380 
	1384 1390 1394 1395 1396 1402 1417 1419 1429 1438 1440 1442 1446 1449 1460 1463 1467 1468 1476 1477 1479 1481 1486 1495 1496 1504 1507 1508 1512 1516 1531 1540 1542 1544 1546 1552 1553 1555 1558 1574 1578 1580 1584 1585 1588 1595 1596 1597 1602 1605 
	1609 1610 1611 1631 1640 1644 1652 1653 1657 1661 1663 1664 1666 1673 1678 1685 1690 1696 1702 1705 1706 1711 1717 1720 1725 1726 1727 1730 1732 1735 1738 1739 1741 1746 1750 1755 1764 1766 1771 1772 1775 1777 1780 1783 1790 1799 1801 1802 1806 1814 
	1815 1818 1820 1828 1830 1832 1833 1835 1837 1838 1843 1849 1851 1852 1854 1858 1859 1866 1881 1885 1893 1898 1904 1907 1911 1913 1922 1928 1930 1942 1949 1951 1954 1961 1962 1967 1969 1979 1986 1987 1988 1989 1993 1998 1999 2004 2006 2008 2009 2011 
	2015 2017 2025 2028 2030 2031 2032 2033 2040 2042 2043 2045 2049 2054 2057 2059 2060 2061 2063 2064 2066 2068 2069 2071 2072 2092 2095 2096 2097 2098 2099 2102 2104 2106 2107 2113 2115 2118 2127 2128 2137 2139 2150 2151 2152 2153 2156 2159 2161 2167 
	2168 2169 2174 2182 2184 2187 2189 2195 2198 2200 2214 2219 2222 2223 2224 2225 2233 2236 2238 2239 2245 2248 2249 2250 2251 2256 2261 2262 2263 2266 2267 2269 2270 2284 2285 2286 2292 2293 2294 2297 2302 2306 2308 2312 2320 2330 2337 2338 2340 2341 
	2342 2344 2352 2356 2357 2358 2361 2362 2363 2375 2382 2383 2386 2392 2394 2397 2400 2401 2406 2407 2414 2422 2423 2425 2426 2429 2431 2438 2439 2441 2443 2444 2451 2463 2464 2469 2470 2472 2489 2490 2491 2494 2495 2500 2501 2502 2509 2510 2513 2518 
	2519 2523 2524 2525 2527 2534 2536 2537 2539 2543 2546 2549 2550 2551 2553 2556 2561 2563 2565 2567 2568 2571 2573 2587 2591 2592 2595 2600 2601 2607 2610 2612 2613 2615 2616 2618 2623 2624 2625 2638 2640 2641 2644 2652 2654 2655 2656 2661 2662 2663 
	2672 2674 2675 2676 2679 2680 2681 2685 2686 2687 2688 2691 2692 2703 2705 2706 2709 2711 2718 2720 2722 2723 2726 2727 2729 2730 2732 2735 2738 2740 2748 2751 2754 2756 2757 2759 2760 2762 2765 2767 2771 2773 2776 2777 2779 2782 2794 2795 2797 2799 
	2803 2804 2805 2813 2814 2817 2833 2835 2840 2843 2852 2854 2864 2871 2877 2882 2885 2897 2899 2903 2914 2916 2917 2919 2920 2932 2933 2935 2936 2938 2939 2941 2942 2946 2947 2948 2954 2955 2957 2958 2961 2963 2966 2971 2975 2983 2984 2985 2986 2987 
	2992 2994 2995 2998 2999 3002 3004 3005 3007 3010 3011 3012 3015 3016 3017 3021 3024 3025 3029 3030 3033 3036 3039 3041 3046 3047 3051 3052 3053 3054 3062 3064 3077 3078 3079 3082 3085 3088 3090 3092 3093 3096 3097 3098 3102 3103 3105 3107 3114 3118 
	3121 3122 3128 3129 3130 3131 3135 3137 3140 3141 3142 3146 3149 3150 3152 3165 3169 3171 3174 3175 3177 3183 3184 3185 3186 3189 3194 3196 3199 3200 3201 3202 3207 3212 3216 3218 3221 3222 3230 3231 3235 3239 3245 3247 3248 3249 3255 3256 3258 3262 
	3263 3267 3268 3269 3270 3273 3274 3276 3277 3281 3284 3289 3292 3293 3294 3296 3301 3302 3305 3307 3308 3317 3318 3322 3328 3329 3331 3333 3334 3335 3338 3341 3345 3346 3348 3349 3350 3351 3356 3359 3360 3361 3364 3367 3369 3378 3379 3380 3384 3386 
	3389 3392 3393 3394 3399 3401 3407 3412 3417 3418 3419 3421 3423 3425 3426 3435 3437 3440 3442 3443 3445 3446 3449 3452 3454 3455 3457 3461 3464 3472 3474 3476 3477 3478 3479 3480 3482 3483 3484 3485 3487 3489 3490 3491 3495 3501 3503 3507 3510 3512 
	3513 3519 3524 3526 3527 3528 3529 3530 3540 3541 3542 3544 3549 3550 3554 3557 3558 3560 3563 3568 3574 3575 3576 3581 3582 3586 3587 3589 3594 3598 3599 3600 3602 3604 3608 3610 3617 3625 3628 3630 3632 3636 3638 3639 3640 3641 3642 3655 3661 3664 
	3667 3670 3676 3678 3682 3683 3685 3687 3691 3702 3707 3709 3711 3712 3716 3724 3725 3731 3733 3734 3738 3739 3740 3747 3748 3749 3751 3753 3759 3760 3761 3763 3764 3766 3767 3775 3777 3778 3779 3780 3782 3790 3799 3800 3801 3803 3807 3809 3814 3819 
	3821 3824 3825 3831 3832 3837 3838 3841 3853 3854 3862 3864 3870 3871 3872 3873 3875 3878 3885 3887 3889 3891 3895 3896 3905 3906 3908 3909 3916 3920 3921 3927 3931 3935 3941 3943 3945 3951 3954 3958 3959 3962 3968 3982 3983 3984 3996 4002 4016 4017 
	4019 4033 4036 4037 4038 4043 4044 4048 4057 4060 4061 4065 4068 4070 4073 4076 4077 4081 4092 4093 4096 4100 4107 4121 4128 4129 4130 4133 4135 4137 4139 4142 4150 4152 4154 4162 4163 4172 4175 4176 4177 4178 4179 4183 4196 4198 4204 4209 4215 4221 
	4223 4225 4226 4227 4229 4232 4233 4234 4236 4239 4241 4243 4244 4246 4248 4249 4251 4252 4256 4257 4258 4260 4263 4266 4267 4269 4274 4282 4283 4285 4286 4287 4290 4291 4292 4294 4299 4300 4302 4310 4313 4315 4316 4322 4324 4325 4336 4339 4340 4342 
	4346 4350 4355 4357 4366 4368 4372 4375 4379 4382 4384 4396 4398 4402 4407 4412 4414 4419 4423 4427 4429 4432 4433 4434 4436 4443 4445 4447 4451 4453 4454 4455 4457 4461 4465 4467 4468 4472 4476 4477 4478 4484 4487 4496 4497 4499 4500 4501 4503 4508 
	4511 4518 4527 4530 4533 4534 4543 4548 4550 4553 4556 4560 4566 4567 4568 4570 4578 4580 4581 4582 4585 4589 4590 4593 4600 4605 4606 4607 4610 4611 4624 4626 4628 4631 4632 4639 4640 4642 4645 4652 4653 4654 4656 4659 4660 4661 4666 4667 4668 4670 
	4672 4674 4682 4687 4696 4700 4701 4702 4704 4708 4714 4715 4717 4726 4727 4728 4729 4734 4735 4736 4737 4738 4742 4743 4746 4748 4751 4752 4755 4762 4763 4776 4780 4782 4786 4787 4791 4792 4794 4795 4797 4800 4805 4807 4810 4813 4814 4816 4817 4820 
	4821 4823 4825 4827 4829 4830 4834 4837 4846 4847 4854 4855 4859 4862 4864 4867 4868 4870 4871 4872 4873 4874 
}

normal_winter = LIST {
	6 17 18 24 25 28 32 41 50 51 70 74 106 110 112 159 165 205 207 221 225 226 229 234 256 298 309 311 369 386 389 395 398 423 439 457 472 474 511 516 545 550 587 595 630 660 663 680 691 
	715 723 724 726 730 763 770 782 792 796 831 841 877 885 889 897 902 903 904 924 927 932 934 937 947 965 968 999 1023 1026 1027 1038 1039 1063 1079 1084 1090 1095 1101 1107 1110 1116 1123 1129 1140 1149 1161 1170 1171 1173 
	1174 1178 1179 1200 1204 1207 1231 1238 1241 1243 1246 1265 1284 1287 1302 1303 1317 1322 1323 1331 1345 1354 1355 1357 1361 1374 1375 1386 1398 1407 1408 1409 1414 1416 1424 1426 1431 1452 1462 1465 1469 1471 1472 1473 1474 1480 1484 1488 1499 1502 
	1503 1520 1534 1543 1548 1551 1561 1565 1568 1604 1606 1608 1625 1626 1628 1633 1634 1636 1641 1642 1645 1658 1659 1662 1675 1676 1681 1694 1703 1704 1708 1709 1723 1728 1734 1737 1740 1742 1749 1751 1756 1781 1789 1791 1793 1807 1816 1826 1827 1868 
	1897 1903 1909 1920 1921 1932 1950 1953 1963 1965 1968 1973 2010 2018 2020 2026 2034 2037 2048 2050 2053 2058 2073 2075 2083 2086 2100 2117 2130 2144 2146 2154 2155 2170 2171 2172 2175 2176 2191 2196 2199 2211 2212 2221 2228 2230 2231 2242 2243 2247 
	2255 2273 2296 2300 2326 2328 2345 2348 2360 2369 2371 2378 2385 2396 2409 2419 2421 2427 2432 2446 2459 2475 2481 2485 2493 2496 2503 2508 2521 2529 2531 2533 2575 2578 2586 2599 2604 2609 2611 2617 2620 2626 2633 2639 2643 2645 2658 2659 2682 2689 
	2698 2712 2713 2714 2716 2719 2721 2728 2731 2739 2746 2747 2750 2753 2758 2778 2783 2800 2801 2810 2811 2816 2819 2821 2822 2823 2842 2849 2851 2853 2861 2875 2876 2881 2884 2886 2888 2889 2901 2913 2915 2924 2928 2929 2930 2940 2943 2962 2977 2982 
	2993 2996 3020 3022 3028 3038 3048 3059 3067 3070 3089 3108 3109 3123 3125 3126 3133 3147 3151 3163 3166 3167 3178 3181 3182 3193 3198 3203 3208 3210 3211 3214 3217 3220 3233 3244 3252 3254 3257 3271 3283 3288 3295 3298 3312 3313 3319 3321 3323 3324 
	3325 3336 3347 3365 3371 3381 3382 3383 3385 3390 3391 3397 3409 3415 3422 3429 3433 3441 3451 3456 3466 3470 3481 3492 3498 3500 3504 3505 3509 3517 3537 3553 3555 3556 3562 3564 3571 3603 3611 3613 3618 3623 3627 3637 3658 3662 3665 3684 3697 3701 
	3714 3715 3717 3719 3728 3732 3741 3746 3750 3769 3771 3772 3787 3788 3791 3792 3794 3811 3816 3818 3822 3829 3830 3833 3834 3835 3840 3843 3844 3846 3851 3855 3861 3876 3881 3899 3900 3913 3917 3918 3926 3938 3942 3944 3947 3948 3953 3966 3969 3972 
	3973 3975 3977 3978 3990 3994 4000 4022 4024 4029 4030 4034 4039 4041 4042 4063 4078 4079 4080 4088 4106 4111 4118 4119 4120 4131 4134 4136 4138 4146 4147 4148 4151 4153 4166 4169 4171 4180 4182 4185 4193 4199 4218 4228 4235 4237 4276 4278 4284 4297 
	4301 4312 4321 4323 4326 4328 4335 4337 4344 4347 4351 4352 4354 4358 4359 4361 4364 4365 4374 4380 4383 4385 4386 4387 4388 4390 4391 4397 4399 4404 4418 4421 4422 4426 4428 4431 4440 4441 4444 4458 4460 4462 4469 4473 4480 4510 4512 4514 4519 4529 
	4538 4540 4542 4549 4551 4554 4557 4559 4574 4576 4577 4579 4584 4587 4594 4595 4609 4614 4634 4643 4649 4650 4657 4658 4677 4678 4685 4686 4688 4691 4693 4710 4716 4719 4732 4733 4759 4765 4770 4778 4779 4783 4784 4790 4803 4836 4856 4857 4865 4877 
}

severe_winter = LIST {
	2 14 22 53 62 63 80 104 124 126 128 147 148 155 178 206 231 242 248 252 271 305 322 328 370 372 397 405 413 418 438 464 470 473 540 546 552 556 561 562 582 593 605 615 633 640 641 653 656 
	666 670 671 686 689 690 700 702 713 720 736 738 781 784 798 820 829 830 834 837 838 849 853 854 874 879 966 980 1003 1008 1014 1032 1034 1045 1046 1048 1085 1094 1098 1105 1128 1144 1162 1176 1185 1192 1209 1210 1230 1233 
	1239 1247 1254 1266 1267 1271 1272 1277 1280 1282 1325 1338 1339 1412 1432 1441 1448 1458 1485 1498 1500 1517 1518 1526 1536 1557 1577 1579 1589 1593 1598 1600 1612 1627 1648 1667 1674 1677 1691 1713 1715 1731 1743 1776 1779 1792 1794 1839 1861 1864 
	1882 1889 1925 1926 1935 1947 1966 1977 1995 2047 2108 2116 2121 2138 2158 2162 2207 2208 2216 2244 2257 2282 2299 2307 2310 2311 2335 2355 2359 2376 2381 2402 2442 2449 2473 2477 2478 2492 2512 2540 2547 2548 2552 2585 2628 2637 2646 2669 2673 2683 
	2693 2724 2725 2736 2770 2772 2774 2781 2791 2815 2818 2834 2867 2874 2893 2898 2927 2945 2960 2980 3001 3008 3018 3019 3026 3058 3065 3117 3120 3124 3132 3134 3154 3164 3176 3241 3251 3260 3287 3314 3352 3357 3363 3387 3434 3448 3458 3514 3516 3520 
	3552 3565 3573 3577 3580 3596 3609 3622 3634 3654 3671 3698 3699 3713 3737 3742 3755 3820 3826 3848 3880 3884 3901 3924 3925 3932 3934 3956 3957 3963 3964 3971 3981 3992 3999 4001 4006 4011 4021 4025 4026 4066 4069 4091 4099 4105 4143 4173 4187 4197 
	4213 4214 4259 4264 4275 4280 4289 4298 4405 4416 4439 4466 4475 4494 4504 4505 4521 4555 4612 4613 4637 4641 4684 4741 4754 4768 4822 4848 4861 
}

arid = LIST {
	36 40 66 79 87 90 95 132 145 154 162 172 212 223 245 258 284 304 319 326 366 378 382 399 400 406 408 414 415 421 422 424 454 496 499 510 513 519 535 542 547 570 611 631 644 652 679 681 688 
	712 737 740 741 755 762 780 800 807 850 861 862 916 923 926 970 972 1015 1074 1076 1080 1113 1135 1154 1157 1167 1168 1196 1255 1273 1288 1299 1306 1311 1314 1318 1326 1333 1334 1336 1341 1351 1358 1363 1391 1405 1413 1418 1443 1450 
	1455 1459 1478 1491 1494 1519 1523 1527 1539 1572 1573 1616 1621 1651 1669 1689 1710 1716 1747 1753 1759 1787 1795 1819 1824 1829 1836 1841 1865 1872 1878 1888 1890 1891 1899 1929 1936 1957 1964 1976 1990 2001 2005 2007 2101 2112 2123 2148 2160 2164 
	2197 2201 2237 2260 2276 2279 2289 2291 2329 2336 2380 2384 2388 2393 2415 2420 2445 2456 2465 2474 2486 2488 2583 2588 2593 2594 2666 2667 2678 2752 2824 2829 2831 2841 2844 2862 2873 2905 2906 2951 2952 3035 3080 3138 3144 3195 3205 3225 3226 3237 
	3238 3246 3282 3310 3375 3395 3438 3469 3471 3475 3486 3522 3523 3525 3532 3570 3615 3631 3644 3647 3656 3669 3681 3789 3795 3836 3845 3894 3929 3936 3952 4032 4047 4053 4054 4082 4116 4123 4126 4202 4203 4230 4242 4261 4265 4295 4303 4318 4332 4334 
	4356 4362 4381 4437 4463 4513 4515 4531 4596 4616 4618 4622 4633 4689 4747 4756 4758 4761 4798 4806 4832 4840 4841 4853 4881 
}